############################################################################################################################################################################################
############################################################################################################################################################################################
##                                                                                                                                                                                        ##
##                                                                                                                                                                                        ##
##                                                                                                                                                            +                           ##
##                                                                                                          ######################                #######################                 ##
##                                   #########                                             #########                                                                                      ##
##                                   #########                                             #########                                                                                      ##
##                                   #########                                             #########                   +                           +                                      ##
## ##############################################################################################################################################################                         ##
##                                                                                                                                                                                        ##
##                                                                                                                                                                       ###################
##                                                                                                                                                                                        ##
##                                                            +                                                                                                 +                         ##
##                                                         #######                                           ##                                             #########                     ##
##                                                         #######                                           ##                                             #########                     ##
##                                       +                 #######                                           ##                                             #########                     ##
##              ################       #############       ###############################################################################################################                ##
##                                                                                                                                                                                        ##
##                                                                                                                                                                                        ##
##                                                                                                                                                                                        ##
## ##########                                                                                     +                                                          +                            ##
##                                                 ############                                 ###########                                          ################                     ##
##                                                                                                                                                                                        ##
##                                    +                                     +                                           +                                                                 ##
##                 ###################################           ##########################                   #######################                                                     ##
##                                                                                                                                                                      ##########        ##
##                                                                                                                                                                                        ##
##                                                                                                                                 #############                                          ##
##                                                                                                                                                                                        ##
##                                       +                                              +                                                                     +                           ##
##             ############################################      ##############      #########      ######################    ###############   ##############################            ##
##             ############################################      ##############      #########      ######################    ############### % ##############################    	  ##
##             ############################################  %%  ##############  %%  #########  %%  ###################### %% ############### % ##############################            ##
##             #########  ::::::::::::::::::::::::::::::::::::::::::::::::::::::::::::::::::::::::::::::::::::::::::::::::::::::::::::::::::::::::::::::::::::::::  ##########            ##
############################################################################################################################################################################################
############################################################################################################################################################################################